..s...........c#
.......c.......#
############...#
c#.............#
...............#
#...############
................
...........c...e
.......######..#
####......c.....
####c........AAA
####AAAAAA..c###
################
